###############################################################
#                                                             #
#                                                             #
#                                                             #
#                                                             #
#                     ##################                      #
#                     #                #                      #
#                     #                #                      #
#                     #                #                      #
#                     #                #                      #
#                     ##################                      #
#                                                             #
#                                                             #
#                                                             #
#                                                             #
#                                                             #
#                                                             #
#                                                             #
###############################################################