###############################################################
#                                                             #
#                                                             #
#                                                             #
#                                                             #
#                     ##################                      #
#                     #                #                      #
#                     #                #                      #
#                     #                #                      #
#                     #                #                      #
#                     ##### ############                      #
#                                                             #
#                                                             #
#                                                             #
#                                                             #
#                                                             #
#                                                             #
#                                                             #
###############################################################